###########
#.........#
#..###....#
#.#.......#
#.#..@....#
#.........#
#..###....#
#..#...#..#
#..#..##..#
#.........#
###########
