#........##
#.........#
#..####...#
#.#....#..#
#.#....#..#
#..........
#..###.....
#..#.......
#..#...@...
#..........
###########